R 600 400
NO ./path_to_the_north_texture
SO ./path_to_the_south_texture
WE ./path_to_the_west_texture

EA ./path_to_the_east_texture
S ./path_to_the_sprite_texture
F 220,100,0
C 225,30,0


11111111111     1111111111      1111111111     1111111111111111111111111111
11111111111     1111111111      1111111111     1111111111111111111111111111
11S00000001     1100000001      1000000001     1000000000000000000000000001
11000000011     1100000001      1000000001     1000000000111111111000000001
11000100001     1100000011      1000000001     100000000011      1000000001
11000000011     1100000000      1000000001     100000000011      1000000001
11000000011     1100000001      1000000001     100000000011      1000000001
11000000011     1100000001      1000200001     100000000011      1000000001
11000000011     1100000001      1000000001     1000000000011111111000000001
110000000111111111000000011111111000000001111111000000000000000000000000001
110000200000002000000000020000000000000000000000000000000000000000000000001
110000000011111110000000011111111000000001111111000000000111111111111111111
11000000001111111100000001      1000000001     10000000001
11000000001     1100000001      1000000011     10000000001
10000000001     1100000001      1000000011     10000000001
10000000001     1100000001      1000000011     10000000001
10000000001     1100000001      1000000011     10000000001
11000000001     1100000001      1000000011     10000000001
11000000001     1100000001      1000000011     10000000001
10000000001     1110000001      1000000001     10000000001
10000000011     1111111111      1111111111     11111111111
11000000011
10000000011     1111111111       1111111111111111111111111     1111111111111111111111111111111
10000000011     1000000001       1000000000000000000000001     1110000000000000000000000000011
10000000011     1000020001       1000000000000000000000001     1100000001000000000000000000001
10000000011     1000000001       1000000000000000000000001     1100000000000000000000000000001
11000000011     1000000011       1000000001111111100000001     1100000000111111111111000000001
11000000011     1000000001       1000000011     1100000001     11000000011          1111001111
11000000011     1000000001       1000000011     1100000001     11000000011          1111000001
11000000011     1000000001       1000000011     1100000001     11000000011          1000000001
11000000011     1000000001       1000000011111111100000001     1100000000111111111111000000111
1100000001111111110000000111111111000000000000000000000001111111100000001000000000000000000001
1100000000000000000000000000000000000000000000000000000000000000000000000000000000000000000001
1100000000000000000000001111111111000000000000000110000001111111000000000000000000000000000011
11000000001111111100000001       1100000001111111100000001     1000000000111111111111111111111
11000000011     1100000011       1100000001     1100000001     10000000001
11000000011     1100000011       1100000001     1100000001     10000000001
11000000011     1100000011       1100000001111111000000001     10000000001
11000000011     1100000011       1100000000000000000000001     10000000001
11000000011     1100000011       1100000000000000000000001     10000000001
11000000011     1100000011       1000000000000000000000001     10000000001
11111111111     1111111111       1111111111111111111111111     11111111111
11111111111     1111111111       1111111111111111111111111     11111111111