NO ./textures/wall1.xpm
SO ./textures/wall2.xpm
WE ./textures/wall3.xpm
EA ./textures/cara.XPM

F 165,111,
C 75,250,249

        11111111111111111111111111 
        10000000001100000000001001 
        1011000001110000000000001 
        100100000000000000000000111
111111111011000001110000000000000001
10000000001100000111011110011111111
11110111111111011100000010001
11110111111111011101010010001
11000000110101011100000010001
10000000000000001100000010001
10000000000000001101010010001
1100000111010101111101111000111
11110111 111S101 101111010001 
11111111 1111111 11111111111