NO ./textures/wall1.xpm
SO ./textures/wall2.xpm

F 165,111,22

WE ./textures/wall3.xpm
EA ./textures/wall4.xpm


C 35,250,219

        11111111111111111111111111 
        100000000110000000001001 
        10110000011100000000000011
        100100000000000000000000111
111111111011000001110000000000000001           11111
10000000001100000111011110011111111           100001
11110111111111011100000010001                 111111
11110111111111011101010010001
11000000110101011100000010001
10000000000000001100000010001
10000000000000001101010010001
1100000111010001111101111000111
11110111 1111S1 101111010001 
11111111 1111111 11111111111
