R 600 400
EA ./path_to_the_east_texture
S ./path_to_the_sprite_texture
NO ./path_to_the_north_texture

SO ./path_to_the_south_texture
WE ./path_to_the_west_texture
F 220,100,0
C 225,30,0

   1111111111111111111111111
   1000000000110000000001
1111000001110000002000001
1001000000000000000000001
111111111011000001110000100000001
100000000011000001110111111111111
11110111111111011100000001001
11110111111111011101010011001111111
11000000110101011100000010000000001
10002000000000001100000010000000001
10000000000000001101010010000000001
11000001110101011111011110N01111111
11110111 1110101 101111010001
11111111 1111111 111111111111