R 600 600
NO textures/bluestone.xpm
SO textures/wall_2.xpm
WE textures/purplestone.xpm

EA textures/wall_1.xpm
S textures/pillar.xpm
F 220,100,0
C 157,212,223

11111111
10001111
10N01111
10200011
10001111
11111111